NO  ./mnt/c/Users/sruza/OneDrive/Desktop/проекты/finish/Cub3d/textures/N.xpm
SO  ./mnt/c/Users/sruza/OneDrive/Desktop/проекты/finish/Cub3d/textures/S.xpm
WE  ./mnt/c/Users/sruza/OneDrive/Desktop/проекты/finish/Cub3d/textures/W.xpm
EA  ./mnt/c/Users/sruza/OneDrive/Desktop/проекты/finish/Cub3d/textures/E.xpm

F 0, 85, 10
C 25, 45, 100


1111111
110111
10E11
1001
1111111

